1111111111111111111111111111111
1000000000000000100000000000001
100CCC0000010000E10000001000001
1000000000101000100000001000001
1000000P00010000000000C01000001
10000000000000C0000000001000001
100000H000000000000000001000001
10000000000000H000000V001C00001
10000000V0000000000000001000001
1000C00000000001000000001000001
100000000000001C000000001000H01
10000000C0000001000000001000001
100000000000000000000V001000001
100V000000000000000000001000001
1000000H000000V00000000010V0001
1000000000000000000000001000001
1000000000000000000000001000001
1111111111111111111111111111111
