1111111
1P00C01
1111111
1000E01
1000001
1000001
1000001
1000001
1111111
