1111111111111111111111111111
1000000011111111100000000001
1000000000000000000000000001
1000000000010010000000C00001
1000000000010010000000000001
100000E000010010000000000001
1000000000010010000000000001
100000C00001000000C000000001
1000000000010000000000000001
1000P00000010000000000000001
1000000000010000000000000001
1000000000000000000000000001
1111111111111111111111111111
