111111111111111111111
100000000000000010001
100CCC0000010000E1001
100000000010100010001
1000000P0001000000001
10000000000000C000001
100000000000000000001
111111111111111111111
