11111111111111111111111111
10000000000000000000000001
10E000010000C0000000000001
10000000100000000000000001
10000000000000000000000001
10000P00000000000000000001
10000000000000000000000001
10000000000000000000000001
10000000000000000000000001
10000000000000000000000001
10000000000000000000000001
10000000000000000000000001
11111111111111111111111111
