111111111111111111111111111111111111111111111111111111111
1P0000000000000000000000000000000000000000000000000000001
1C0000000000000000000000000000000000000000000000100000001
100000000000000000000000000000000000000000010000100000001
100000001000000000000000000000000000000000010000100000001
100000000000000000000000000000000000000000010000100000001
100000000000000000000000000000000000000000010000100000001
100000000000000000000000C00000000000000000010000100000001
100000000100000000000000000000000000000000010000100000001
000000000100000000000000000000000000000000010000100000001
100000000100000000000000000000000000000000010000100000001
10000000010000000C00000000000000000C000000010000100000001
00E000000100000000000000000000000000000000010000000000001
1000000001000000000000000000C0000000000000100000000000001
111111111111111111111111111111111111111111111111111111111
111111111111111111111111111111111111111111111111111111111
111111111111111111111111111111111111111111111111111111111
111111111111111111111111111111111111111111111111111111111
111111111111111111111111111111111111111111111111111111111
111111111111111111111111111111111111111111111111111111111
111111111111111111111111111111111111111111111111111111111
111111111111111111111111111111111111111111111111111111111
111111111111111111111111111111111111111111111111111111111
