11111111111111111111111111111111111111111111111111111111111
1P000000000000000000000000000000000000000000000000000000001
1C000000000000000000000000000000000000000000000000001000001
10000000000000000000000000000000000000000000000000001000001
10000000000000000000000000000000000000000000000000001000001
10000000000000000000000000000000000000000000000000001000001
10000000000000000000000000000000000000000000000000001000001
1000000000000000000000000000C000000000000000000000001000001
10000000000000000000000000000000000000000000000000001000001
10000000000000000000000000000000000000000000000000001000001
10000000000000000000000000000000000000000000000000001000001
100000000000000000000C00000000000000000C0000000000001000001
10000000000000000000000000000000000000000000000000000000001
10000000000000000000000000000000000000000000000000000000001
10000000000000000000000000000000000000000000000000000000001
10000000000000000000000000000000000000000000000000000000001
10000000000000000000000C00000000000000000000000000000000001
10000000000000000000000000000000000000000000000000000000001
1000000000000000000000000000C000000000000C00000000000000001
10000000000000000000000000000000000000000000000000000000001
10000000000000000000000000000000000000000000000000000000001
10000000000000000000000000000000000000000000000000000000001
10000000000000000000000000000000000000000000000000000000001
1000000000000000000000000000000000000000C000000000000000001
10000000000000000000000000C00000000000000000000000000000001
10000000000000000000000000000000000000000000000000000000001
10000000000000000000000000000000000000000000000000000000001
10000000000000000000000000000000000000000000000000000000001
10000000000000000000000000000000000000000000000000000000001
1E000000000000000000000000000000000000000000000000000000001
11111111111111111111111111111111111111111111111111111111111
