1111111
1000111
10001
10001
11111
